NO ./map/test_texture/path_to_the_north_texture
SO ./map/test_texture/path_to_the_south_texture
WE ./map/test_texture/path_to_the_west_texture
EA ./map/test_texture/path_to_the_east_texture

F 255,0,0
C 225,30,0

		1111111111111111111111111
		100000 000110000000000001
		1011000001110000000000001
		1001000000000000000000001
111111111011000001110000000000001
100000000011000001110111111111111
11110111111111011100000010001
11110111111111011101010010001
11000000110101011100000010011
100000000000000000000000101
10000000000000001101010010011
11000001010101011111011110N0111
11110111111101011101111010001
11111111 1111111 111111111111