NO ./map/test_texture/path_to_the_north_texture.xpm
SO ./map/test_texture/path_to_the_south_texture.xpm
WE ./map/test_texture/path_to_the_west_texture.xpm
EA ./map/test_texture/path_to_the_east_texture.xpm

F 120,30,0
C 255,0,255

111111
100001
1S0001
110001
111111



  










