NO ./map/test_texture/path_to_the_north_texture.xpm
SO ./map/test_texture/path_to_the_south_texture.xpm
WE ./map/test_texture/path_to_the_west_texture.xpm
EA ./map/test_texture/path_to_the_east_texture.xpm

F 255,0,0
C 225,30,0

        1111111111 11111111111111111111111
        1001111111 111111111111111
        100000000111100000000000011
        100100100000000000010000001
1111111110000000011110000000000001
100000000011000001 110111100111111
111001111111111111 10000010001
111001             11010010001
110001 11111111111 10000010011
100001 10000000001 1000001011
100001 100000000011 11010010011
110001110101010111 11011110N0111
11000000011101011111111010001
11111111111111111111111111111



  












