NO ./map/test_texture/path_to_the_north_texture
SO ./map/test_texture/path_to_the_south_texture
WE ./map/test_texture/path_to_the_west_texture
EA ./map/test_texture/path_to_the_east_texture

F 255,0,0
C 225,30,0

        1111111111 111111111 1111111111111
        1111111111 111111111111111
        1000000001 1100000000000011
        1001001001 1000000010000001
111111111011000001 110000000000001
100000000011000001 110111111111111
111101111111111111 10000010001
111101             11010010001
110001 11111111111 10000010011
100001 10000000001 1000001011
100001 100000000011 11010010011
110001110101010111 11011110N0111
11110111111101011111111010001
11111111 1111111 111111111111



  












