1111111111111111111111111
1000000000220000000000001
102200000222000P000000001
1002000000000000000000001
1111111111111111111111111